haha
 +  -  +  -  +  -  +  -  +  -  +  -  +  -  +  -  +  -  +  -  + 
 |  *              |                                   |     | 
 +  -  +  -  +     +  -  +  -  +  -  +  -  +     +     +     + 
 |           |     |                 |           |     |     | 
 +  -  +     +     +     +  -  +     +     +  -  +     +     + 
 |           |     |     |     |           |     |           | 
 +     +  -  +     +     +     +  -  +  -  +     +  -  +     + 
 |           |     |     |                             |     | 
 +     +     +     +     +     +  -  +  -  +  -  +  -  +     + 
 |     |           |     |                       |           | 
 +     +  -  +  -  +     +     +  -  +  -  +     +     +  -  + 
 |                       |                 |     |           | 
 +  -  +  -  +  -  +  -  +  -  +  -  +     +     +  -  +     + 
 |     |           |                 |     |           |     | 
 +     +     +     +     +     +  -  +     +  -  +     +     + 
 |           |           |                 |           |     | 
 +     +  -  +  -  +  -  +  -  +  -  +  -  +     +  -  +     + 
 |           |                 |           |                 | 
 +  -  +     +     +  -  +     +  -  +     +  -  +  -  +  -  + 
 |                 |                                      X  | 
 +  -  +  -  +  -  +  -  +  -  +  -  +  -  +  -  +  -  +  -  + 
